[['0' '0' '0' '0' '0' '0' '0' '0' '0' '0' '0' '0' '0' '0' '0' '0' '0' '0' '0' '0' '0' '0' '0' '0' '0' '0' '0' '0' '0' '0' '0' '0' '0' '0' '0' '0']
 ['0' '0' '0' '0' '0' '0' '0' '0' '0' '0' '0' '0' '0' '0' '0' '0' '0' '0' '0' '0' '0' '0' '0' '0' '0' '0' '0' '0' '0' '0' '0' '0' '0' '0' '0' '0']
 ['0' '0' '0' '0' '0' '0' '0' '0' '0' '0' '0' '0' '0' '0' '0' '0' '0' '0' '0' '0' '0' '0' '0' '0' '0' '0' '0' '0' '0' '0' '0' '0' '0' '0' '0' '0']
 ['0' '0' '0' '0' '0' '0' '0' '0' '0' '0' '0' '0' '0' '0' '0' '0' '0' '0' '0' '0' '0' '0' '0' '0' '0' '0' '0' '0' '0' '0' '0' '0' '0' '0' '0' '0']
 ['0' '0' '0' '0' '0' '0' '0' '0' '0' '0' '0' '0' '0' '0' '0' '0' '0' '0' '0' '0' '0' '0' '0' '0' '0' '0' '0' '0' '0' '0' '0' '0' '0' '0' '0' '0']
 ['0' '0' '0' '0' '0' '0' '0' '0' '0' '0' '0' '0' '0' '0' '0' '0' '0' '0' '0' '0' '0' '0' '0' '0' '0' '0' '0' '0' '0' '0' '0' '0' '0' '0' '0' '0']
 ['0' '0' '0' '0' '0' '0' '0' '0' '0' '0' '0' '0' '0' '0' '0' '0' '0' '0' '0' '0' '0' '0' '0' '0' '0' '0' '0' '0' '0' '0' '0' '0' '0' '0' '0' '0']
 ['0' '0' '0' '0' '0' '0' '0' '0' '0' '0' '0' '0' '0' '0' '0' '0' '0' '0' '0' '0' '0' '0' '0' '0' '0' '0' '0' '0' '0' '0' '0' '0' '0' '0' '0' '0']
 ['0' '0' '0' '0' '0' '0' '0' '0' '0' '0' '0' '0' '0' '0' '0' '0' '0' '0' '0' '0' '0' '0' '0' '0' '0' '0' '0' '0' '0' '0' '0' '0' '0' '0' '0' '0']
 ['0' '0' '0' '0' '0' '0' '0' '0' '0' '1' '1' '1' '1' '1' '1' '1' '1' '1' '1' '1' '1' '1' '1' '1' '1' '1' '0' '0' '0' '0' '0' '0' '0' '0' '0' '0']
 ['0' '0' '0' '0' '0' '0' '0' '0' '0' '1' '5' '0' '5' '0' '6' '0' '6' '0' '0' '0' '0' '0' '3' '0' '3' '1' '0' '0' '0' '0' '0' '0' '0' '0' '0' '0']
 ['0' '0' '0' '0' '0' '0' '0' '0' '0' '1' '0' '0' '0' '0' '0' '0' '0' '0' '0' '0' '0' '0' '0' '0' '0' '1' '0' '0' '0' '0' '0' '0' '0' '0' '0' '0']
 ['0' '0' '0' '0' '0' '0' '0' '0' '0' '1' '5' '0' '5' '0' '6' '0' '6' '0' '0' '0' '0' '0' '3' '0' '3' '1' '0' '0' '0' '0' '0' '0' '0' '0' '0' '0']
 ['0' '0' '0' '0' '0' '0' '0' '0' '0' '1' '0' '0' '0' '0' '0' '0' '0' '1' '0' '0' '0' '0' '0' '1' '1' '1' '0' '0' '0' '0' '0' '0' '0' '0' '0' '0']
 ['0' '0' '0' '0' '0' '0' '0' '0' '0' '1' '0' '0' '0' '0' '2' '0' '2' '1' '8' '0' '8' '0' '4' '0' '4' '1' '0' '0' '0' '0' '0' '0' '0' '0' '0' '0']
 ['0' '0' '0' '0' '0' '0' '0' '0' '0' '1' '0' '0' '0' '0' '0' '0' '0' '1' '0' '0' '0' '0' '0' '0' '0' '1' '0' '0' '0' '0' '0' '0' '0' '0' '0' '0']
 ['0' '0' '0' '0' '0' '0' '0' '0' '0' '1' '0' '0' '0' '0' '2' '0' '2' '1' '8' '0' '8' '0' '4' '0' '4' '1' '0' '0' '0' '0' '0' '0' '0' '0' '0' '0']
 ['0' '0' '0' '0' '0' '0' '0' '0' '0' '1' '0' '0' '0' '1' '1' '1' '1' '1' '0' '0' '0' '1' '1' '1' '1' '1' '0' '0' '0' '0' '0' '0' '0' '0' '0' '0']
 ['0' '0' '0' '0' '0' '0' '0' '0' '0' '1' '0' '0' '0' '0' '0' '0' '0' '1' '0' '0' '0' '0' '0' '1' '0' '0' '0' '0' '0' '0' '0' '0' '0' '0' '0' '0']
 ['0' '0' '0' '0' '0' '0' '0' '0' '0' '1' '0' '0' '0' '0' '0' '0' '1' '1' '0' '0' '0' '0' '0' '1' '1' '1' '0' '0' '0' '0' '0' '0' '0' '0' '0' '0']
 ['0' '0' '0' '0' '0' '0' '0' '0' '0' '1' '0' '0' '0' '0' '0' '0' '0' '1' '0' '0' '0' '0' '0' '0' '0' '1' '0' '0' '0' '0' '0' '0' '0' '0' '0' '0']
 ['0' '0' '0' '0' '0' '0' '0' '0' '0' '1' '0' '0' '0' '0' '0' '0' '0' '1' '0' '0' '0' '0' '0' '0' '0' '1' '0' '0' '0' '0' '0' '0' '0' '0' '0' '0']
 ['0' '0' '0' '0' '0' '0' '0' '0' '0' '1' '0' '0' '0' '0' '0' '0' '0' '0' '0' '0' '0' '0' '0' '0' '0' '1' '0' '0' '0' '0' '0' '0' '0' '0' '0' '0']
 ['0' '0' '0' '0' '0' '0' '0' '0' '0' '1' '0' '0' '0' '0' '0' '0' '0' '0' '0' '0' '0' '1' '1' '0' '1' '1' '0' '0' '0' '0' '0' '0' '0' '0' '0' '0']
 ['0' '0' '0' '0' '0' '0' '0' '0' '0' '1' '0' '0' '0' '0' '0' '0' '0' '0' '0' '0' '0' '0' '0' '1' '0' '0' '0' '0' '0' '0' '0' '0' '0' '0' '0' '0']
 ['0' '0' '0' '0' '0' '0' '0' '0' '0' '1' '0' '0' '0' '1' '1' '1' '1' '1' '1' '1' '1' '1' '1' '1' '0' '0' '0' '0' '0' '0' '0' '0' '0' '0' '0' '0']
 ['0' '0' '0' '0' '0' '0' '0' '0' '0' '1' '0' '0' '0' '1' '0' '0' '0' '0' '0' '0' '0' '0' '0' '0' '0' '0' '0' '0' '0' '0' '0' '0' '0' '0' '0' '0']
 ['0' '0' '0' '0' '0' '0' '0' '0' '0' '1' '0' '1' '0' '0' '0' '0' '0' '0' '0' '0' '0' '0' '0' '0' '0' '0' '0' '0' '0' '0' '0' '0' '0' '0' '0' '0']
 ['0' '0' '0' '0' '0' '0' '0' '0' '0' '0' '0' '0' '0' '0' '0' '0' '0' '0' '0' '0' '0' '0' '0' '0' '0' '0' '0' '0' '0' '0' '0' '0' '0' '0' '0' '0']
 ['0' '0' '0' '0' '0' '0' '0' '0' '0' '0' '0' '0' '0' '1' '0' '0' '0' '0' '0' '0' '0' '0' '0' '0' '0' '0' '0' '0' '0' '0' '0' '0' '0' '0' '0' '0']
 ['0' '0' '0' '0' '0' '0' '0' '0' '0' '0' '0' '0' '0' '0' '0' '0' '0' '0' '0' '0' '0' '0' '0' '0' '0' '0' '0' '0' '0' '0' '0' '0' '0' '0' '0' '0']
 ['0' '0' '0' '0' '0' '0' '0' '0' '0' '0' '0' '0' '0' '0' '0' '0' '0' '0' '0' '0' '0' '0' '0' '0' '0' '0' '0' '0' '0' '0' '0' '0' '0' '0' '0' '0']
 ['0' '0' '0' '0' '0' '0' '0' '0' '0' '0' '0' '0' '0' '0' '0' '0' '0' '0' '0' '0' '0' '0' '0' '0' '0' '0' '0' '0' '0' '0' '0' '0' '0' '0' '0' '0']
 ['0' '0' '0' '0' '0' '0' '0' '0' '0' '0' '0' '0' '0' '0' '0' '0' '0' '0' '0' '0' '0' '0' '0' '0' '0' '0' '0' '0' '0' '0' '0' '0' '0' '0' '0' '0']
 ['0' '0' '0' '0' '0' '0' '0' '0' '0' '0' '0' '0' '0' '0' '0' '0' '0' '0' '0' '0' '0' '0' '0' '0' '0' '0' '0' '0' '0' '0' '0' '0' '0' '0' '0' '0']
 ['0' '0' '0' '0' '0' '0' '0' '0' '0' '0' '0' '0' '0' '0' '0' '0' '0' '0' '0' '0' '0' '0' '0' '0' '0' '0' '0' '0' '0' '0' '0' '0' '0' '0' '0' '0']]
 