[
['1', '1', '1', '1', '1', '1', 'U', '1', '1', '1', 'H', '1', '1', '1', 'S', '1', '1'],
['1', '5', '0', '5', '0', '6', '0', '6', '0', '0', '0', '0', '0', '3', '0', '3', '1'],
['1', '0', '0', '0', '0', '0', '0', '0', '0', '0', '0', '0', '0', '0', '0', '0', '1'],
['1', '5', '0', '5', '0', '6', '0', '6', '0', '0', '0', '0', '0', '3', '0', '3', '1'],
['1', '0', '0', '0', '0', '0', '0', '0', '1', '0', '0', '0', '0', '0', '1', '1', '1'],
['1', '0', '0', '0', '0', '2', '0', '2', '1', '7', '0', '7', '0', '4', '0', '4', '1'],
['F', '0', '0', '0', '0', '0', '0', '0', '1', '0', '0', '0', '0', '0', '0', '0', '1'],
['1', '0', '0', '0', '0', '2', '0', '2', '1', '7', '0', '7', '0', '4', '0', '4', '1'],
['1', '0', '0', '0', '1', '1', '1', '1', '1', '0', '0', '0', '1', '1', '1', '1', '1'],
['1', '9', '0', '9', '*', '*', '*', '*', '1', '0', '0', '0', '0', '0', '1', '0', '1'],
['1', '0', '0', '0', '*', '*', '*', '*', '0', '0', '0', '0', '0', '0', '0', '1', '1'],
['1', '9', '0', '9', '*', '*', '*', '*', '1', '0', '0', '0', '0', '0', '0', '0', '1'],
['*', '*', '*', '*', '*', '*', '*', '*', '1', '0', '0', '0', '0', '0', '0', '0', 'P'],
['*', '*', '*', '*', '*', '*', '*', '*', '0', '8', '0', '8', '0', '0', '0', '0', '1'],
['*', '*', '*', '*', '*', '*', '*', '*', '0', '0', '0', '0', '1', '1', '0', 'C', '1'],
['*', '*', '*', '*', '*', '*', '*', '*', '0', '8', '0', '8', '0', '0', '1', '0', '0'],
['*', '*', '*', '*', '*', '*', '*', '*', '1', '1', '1', '1', '1', '0', '1', '0', '0'],
['*', '*', '*', '*', '*', '-', '-', '-', '-', '-', '-', '-', '-', '-', '-', '-', '-'],
['*', '*', '*', '*', '*', '-', '-', '-', '-', '-', '-', '-', '-', '-', '-', '-', '-'],
['*', '*', '*', '*', '*', '-', '-', '-', '-', '-', '-', '-', '-', '-', '-', '-', '-'],
['*', '*', '*', '*', '*', '-', '-', '-', '-', '-', '-', '-', '-', '-', '-', '-', '-'],
]