[
['1', '1', '1', '1', '1', '1', '1', '1', '1', '1', '1', '1', '1', '1', '1', '1', '1', '1', '1', '1', '1', 'P', '1', '1', '1', '1', '1', '1', '1', '1', '1', '1', '1', '1', '1', '1', '1'], 
['1', '4', '0', '4', '0', '0', '0', '0', '0', '0', '0', '0', '1', '0', '0', '0', '0', '2', '0', '2', '1', '0', '0', '0', '0', '0', '0', '0', '0', '3', '0', '3', '1', '2', '0', '2', '1'], 
['1', '0', '0', '0', '0', '0', '0', '0', '1', '0', '0', '0', '1', '0', '0', '0', '0', '0', '0', '0', '1', '0', '0', '0', '0', '0', '0', '0', '0', '0', '0', '0', '1', '0', '0', '0', '1'], 
['1', '4', '0', '4', '0', '0', '0', '0', 'C', '0', '0', '0', '0', '0', '0', '0', '0', '2', '0', '2', '1', '0', '0', '0', '0', '0', '0', '0', '0', '3', '0', '3', '1', '2', '0', '2', '1'], 
['1', '1', '1', '1', '1', '0', '0', '0', '1', '0', '0', '0', '0', '0', '0', '0', '1', '1', '1', '1', '1', '0', '0', '0', '1', '1', '1', '1', '1', '0', '0', '0', '1', '0', '0', '0', '1'], 
['1', '0', '1', '0', '0', '0', '0', '0', '0', '0', '0', '0', '0', '0', '0', '0', '1', '6', '0', '6', '0', '0', '0', '0', '0', '0', '0', '0', 'O', '0', '0', '0', '0', '0', '0', '0', '1'], 
['1', 'U', '1', '0', '0', '0', '0', '0', '0', '0', '0', '0', '0', '0', '1', '1', '1', '0', '0', '0', '0', '0', '0', '0', '0', '0', '0', '0', '1', '0', '0', '0', '0', '0', '0', '0', '1'], 
['1', '0', '0', '0', '0', '0', '0', '0', '0', '0', '0', '0', '0', '0', '0', '0', '1', '6', '0', '6', '0', '0', '0', '0', '0', '0', '0', '0', '1', '0', '0', '0', '0', '0', '0', '0', '1'], 
['1', '0', '0', '0', '0', '0', '0', '0', '1', '0', '0', '0', '0', '0', '0', '0', '1', '0', '0', '0', '1', '1', '1', '1', '1', '1', '1', '1', '1', '0', '0', '0', '1', '0', '0', '0', '1'], 
['1', '0', '0', '0', '0', '0', '0', '0', '1', '7', '0', '7', '0', '0', '0', '0', '0', '0', '0', '0', '0', '4', '0', '4', 'H', '0', '0', '0', '0', '0', '0', '0', '1', '5', '0', '5', '1'], 
['1', '0', '0', '0', '1', '0', '0', '0', '1', '0', '0', '0', '1', '0', '0', '0', '0', '0', '0', '0', '0', '0', '0', '0', '1', '0', '0', '0', '0', '0', '0', '0', '1', '0', '0', '0', '1'], 
['1', '0', '0', '0', '1', '0', '0', '0', '1', '7', '0', '7', '1', '0', '0', '0', '0', '0', '0', '0', '0', '4', '0', '4', '1', '0', '0', '0', '0', '0', '0', '0', '1', '5', '0', '5', '1'], 
['1', '1', '1', 'S', '1', '1', '1', '1', '1', '0', '0', '0', '1', '1', '1', '1', '*', '*', '*', '*', '*', '*', '*', '*', '*', '*', '*', '*', '*', '0', '0', '0', '1', '0', '0', '0', '1'], 
['1', '0', '0', '0', '0', '0', '0', '0', '1', '0', '0', '0', '1', '0', '0', '0', '*', '*', '*', '*', '*', '*', '*', '*', '*', '*', '*', '*', '*', '9', '0', '9', '0', '0', '0', '0', '1'], 
['1', '0', '0', '0', '0', '1', '1', '1', '0', '0', '0', '0', '1', '0', '0', '0', '*', '*', '*', '*', '*', '*', '*', '*', '*', '*', '*', '*', '*', '0', '0', '0', '0', '0', '0', '0', '1'], 
['1', '0', '0', '0', '1', '0', '0', '0', '0', '0', '0', '0', '1', '0', '0', '0', '*', '*', '*', '*', '*', '*', '*', '*', '*', '*', '*', '*', '*', '9', '0', '9', '0', '0', '0', '0', '1'], 
['1', '0', '0', '0', '1', '0', '0', '0', '0', '0', '1', '1', '1', '0', '0', '0', '*', '*', '*', '*', '*', '*', '*', '*', '*', '*', '*', '*', '*', '*', '*', '*', '*', '*', '*', '*', '*'], 
['1', '4', '0', '4', '0', '0', '0', '0', '0', '0', '0', '0', '0', '3', '0', '3', '0', '0', '0', '0', '*', '*', '*', '*', '*', '*', '*', '*', '*', '*', '*', '*', '*', '*', '*', '*', '*'], 
['1', '0', '0', '0', '0', '0', '0', '0', '0', '0', '0', '0', '0', '0', '0', '0', '0', '0', '0', '0', '*', '*', '*', '*', '*', '*', '*', '*', '*', '*', '*', '*', '*', '*', '*', '*', '*'], 
['1', '4', '0', '4', '0', '0', '0', '0', '0', '0', '0', '0', '0', '3', '0', '3', '0', '0', '0', '0', '*', '*', '*', '*', '*', '*', '*', '*', '*', '*', '*', '*', '*', '*', '*', '*', '*'], 
['1', '0', '0', '0', '0', '0', '0', '0', '0', '0', '0', '0', '1', '0', '0', '0', '0', '0', '0', '0', '*', '*', '*', '*', '*', '*', '*', '*', '*', '*', '*', '*', '*', '*', '*', '*', '*'], 
['1', '0', '0', '0', '0', '0', '0', '0', '0', '2', '0', '2', '1', '0', '0', '0', '0', '8', '0', '8', '*', '*', '*', '*', '*', '*', '*', '*', '*', '*', '*', '*', '*', '*', '*', '*', '*'], 
['1', '0', '0', '0', '0', '0', '1', '0', '0', '0', '0', '0', '1', '0', '0', '0', '0', '0', '0', '0', '*', '*', '*', '*', '*', '*', '*', '*', '*', '*', '*', '*', '*', '*', '*', '*', '*'], 
['1', '0', '0', '0', '0', '0', '1', '0', '0', '2', '0', '2', '1', '0', '0', '0', '0', '8', '0', '8', '*', '*', '*', '*', '*', '*', '*', '*', '*', '*', '*', '*', '*', '*', '*', '*', '*'], 
['1', '1', '1', '1', '1', '1', '1', '1', '1', '1', '1', '1', '1', '1', '1', '1', '1', '1', '1', '1', '*', '*', '*', '*', '*', '*', '*', '*', '*', '*', '*', '*', '*', '*', '*', '*', '*']
]